Mm, Mm, Mm, Mm, Mm, Mm, Hhd, Md, Mm, Mm, Mm, Mm, Mm, Mm, Mm, Mm, Hh, Md, Re, Mm, Mm, Mm, Mm, Md, Md, Md, Md, Md, Md
Mm, Mm, Md, Mm, Mm, Mm, Hhd^Vhh, Mm, Mm, Mm, Mm, Mm, Mm, Mm, Mm, Mm, Hh^Vhh, Hh, Re, Mm, Mm, Mm, Mm, Mm, Md, Cte^Edb, 4 Kte, Md, Md
Mm, Mm, 3 Kte, Md, Mm, Mm, Hhd, Mm, Mm, Mm, Gd^Fmw, Mm, Gd^Fp, Gd^Fp, Gd^Fmw, Mm, Hh, Hh, Re, Hh, Hh, Mm, Mm, Mm, Mm, Cte^Edb, Cte^Edb, Md, Md
Mm, Mm, Cte^Edb, Cte^Edb, Mm, Mm, Hh, Hh, Hh, Gd^Fp, Gd^Fmw, Gd^Fp, Gd^Vl, Gd^Fp, Re, Gd^Fp, Gd, Hh, Gd, Re, Re, Mm, Mm, Mm, Mm, Mm, Md, Md, Md
Mm, Mm, Mm, Cte^Edb, Hhd, Hh, Hh, Hh, Hh^Fp, Hh, Gd^Fp, Gd^Fp, Rb^Em, Rb, Gd^Fmw, Re, Rb, Gd, Gs^Efm, Gd, Re, Mm, Mm, Mm, Mm, Mm, Hh^Vhh, Md, Hhd
Mm, Mm, Mm, Hhd, Hh, Hh, Rb^Gvs, Hh, Hh, Gd^Fmw, Gd^Fp, Rb^Em, Gd^Fp, Gd^Fmw, Gd^Fp, Gd^Fp, Rb^Gvs, Rb, Re, Gd, Re, Gd^Es, Gd^Es, Hh, Hh, Hh, Hhd, Hhd, Mm
Mm, Mm, Mm, Mm, Gd^Fp, Gd^Fmw, Rb^Gvs, Gd^Vl, Gd^Fp, Gd^Fp, Re, Re, Gll^Fmw, Gd^Fp, Gd^Fp, Gd^Fetd, Rb^Gvs, Rb^Gvs, Rb^Gvs, Re, Gd^Fp, Rb, Gd, Hh, Gd, Hh, Hh, Mm, Mm
Mm, Mm, Mm, Hh, Hh, Gd^Fp, Gd^Fmw, Rb^Gvs, Gd, Gd^Fp, Re, Gd^Fp, Gs^Em, Gs^Em, Gs^Em, Wwf, Ww, Rb^Gvs, Gd^Fp, Gd^Vl, Gd^Fmw, Rb, Rb, Gd, Gd^Em, Hh, Mm, Mm, Mm
Mm, Mm, Md, Hhd^Vhh, Hhd, Hh, Hh, Gd, Gd, Re, Rb^Gvs, Rb^Gvs, Gs^Vl, Gd^Em, Gs, Wwf, Ww, Ww, Ww, Gd^Fp, Gd^Fp, Gd^Fp, Rb, Gd^Em, Gd^Fp, Gd, Mm, Mm, Mm
Mm, Mm, Mm, Mm, Mm, Hhd, Hh, Gd^Es, Re, Re, Gd, Rb^Gvs, Rb^Gvs, Gd, Gs^Em, Gs, Wwf, Ww, Ww, Gd^Fp, Rb^Gvs, Gd^Fmw, Re, Gd^Em, Gd^Fp, Mm, Mm, Mm, Mm
Mm, Mm, Md, Mm, Mm, Md, Hh, Hh, Re, Gd, Hh, Hh, Hh, Gd, Gs, Gd, Gd^Em, Gd^Fp, Gd^Fp, Rb^Gvs, Rb^Gvs, Gd^Fp, Re, Gd^Em, Gd^Fmw, Gd^Fp, Mm, Mm, Mm
Mm, Mm, Mm, Md, Md, Xu, Xu, Re, Rb, Rb, Xu, Mm, Mm, Gd, Gd, Gd, Gd^Fp, Gd^Fmw, Gd^Fp, Rb^Gvs, Rb^Gvs, Re, Gd, Gd^Fp, Mm, Gd^Fp, Mm, Mm, Mm
Mm, Mm, Mm, Md, Xu, Xu, Xu, Rb, Cud, Xu, Xu, Mm, Xu, Hh, Re, Gd^Em, Gd^Em, Gd^Fp, Gd^Fp, Hh, Rb^Gvs, Re, Gd^Vl, Mm, Mm, Mm, Md, Mm, Mm
Mm, Mm, Mm, Xu, Xu, Xu, Xu, Xu, Ur, Uu, Uu^Vud, Xu, Xu, Re, Rb, Gd, Xu, Xu, Hh, Hh, Gd^Fp, Rb, Gd^Fp, Mm, Mm, Mm, Mm, Mm, Hh
Xu, Xu, Xu, Xu, Xu, Xu, Uu^Vud, Uu, Ur, Uu, Uh, Uu, Ur, Cud, Xu, Xu, Xu, Xu, Xu, Gd^Fp, Hh, Rb, Gd^Fp, Gd^Fp, Hh, Mm, Mm, Mm, Hh
Xu, Xu, Xu, Xu, Xu, Xu, Ur^Em, Uh, Cud, Cud, Uu, Ur, Uu^Vud, Uu, Uh, Xu, Uu^Vud, Xu, Xu, Hh, Hh, Re, Hh, Gd^Fp, Hh, Hh^Fp, Hh^Vhh, Mm, Hh
Xu, Xu, Xu, Xu, Xu, Uu^Tf, Ur, Uh, 1 Kud, Cud, Ur, Ur, Ur, Uu, Uu^Es, Uu, Uh, Uu, Xu, Hh, Re, Re^Em, Mm, Hh, Hh, Hh, Mm, Mm, Hh
Xu, Xu, Xu, Xu, Xu, Uu^Vud, Ur^Em, Uu, Uu, Cud, Ur, Ur, Ur, Cud, Cud, Uu, Ur, Uu, Cud, Rb^Em, Rb, Rb^Em, Mm, Hh^Fp, Hh, Hh, Mm, Mm, Md
Xu, Xu, Xu, Xu, Xu, Uu^Em, Uu^Tf, Uu^Vud, Uu, Uu, Ur, Ur, Uu, 2 Kud, Cud, Ur, Uu, Ur, Xu, Rb, Hh, Re^Em, Mm, Mm, Hh^Vhh, Mm, Md, Mm, Mm
Xu, Xu, Xu, Xu, Xu, Xu, Xu, Uu, Uu, Ur, Uu, Uu, Uu, Cud, Uu, Uh, Uu^Vud, Uu, Xu, Hh, Mm, Md, Mm, Mm, Md, Mm, Mm, Mm, Mm
Xu, Xu, Xu, Xu, Uu^Vud, Uu, Uu^Vud, Xu, Uu, Ur, Uu, Uu^Vud, Uu, Uu, Uu, Uh, Uh, Xu, Xu, Xu, Mm^Xm, Mm^Xm, Mm, Md, Mm^Xm, Mm^Xm, Mm, Mm, Mm
Uu, Xu, Xu, Xu, Xu, Ur, Xu, Xu, Uu, Ur^Em, Uu^Tf, Xu, Xu, Uu, Xu, Uh, Ww, Ww, Ww, Mm, Mm, Mm^Xm, Mm^Xm, Mm^Xm, Mm^Xm, Mm^Xm, Mm^Xm, Mm, Mm^Xm
Ur, Uu, Uu, Xu, Uu^Es, Ur, Uu, Uu, Ur, Ur^Em, Uu^Em, Xu, Xu, Uh, Uu, Xu, Xu, Ww, Ww, Mm, Mm, Mm^Xm, Mm, Mm^Xm, Mm, Mm^Xm, Mm^Xm, Mm^Xm, Mm^Xm
Uu, Ur, Ur, Uu, Ur, Ur, Ur, Ur, Uu, Uu, Xu, Xu, Xu, Uh, Xu, Uu^Tf, Xu, Ww, Ww, Ww, Ww, Ww, Ww, Mm, Mm, Mm^Xm, Mm, Mm^Xm, Mm^Xm
Xu, Uu, Uu, Ur, Uu, Ur, Uu, Uu, Xu, Cud, Uu^Em, Uu^Tf, Uh, Xu, Uu^Em, Uu^Em, Xu, Re, Ww, Ww, Ww, Ww, Ww, Ww, Mm, Mm, Mm, Mm^Xm, Mm^Xm
Xu, Xu, Xu, Uu, Xu, Ur, Xu, Xu, Xu, Uu, Uu, Uh, Uu, Uu, Ur^Es, Uu^Em, Uu, Re^Edb, Re^Edb, Rb^Edb, Rb, Hh, Ww, Ww, Md, Mm, Md, Mm^Xm, Mm^Xm
Xu, Xu, Xu, Xu, Uu^Vud, Ur, Uu^Vud, Xu, Xu, Xu, Xu, Uu, Uu, Uu^Vud, Ur^Es, Uu, Uu^Es, Re^Edb, Cte^Edb, 5 Kte, Hh, Hh, Hh, Mm, Md, Hh^Vhh, Md, Md, Mm^Xm
Xu, Xu, Xu, Xu, Xu, Uu, Xu, Xu, Xu, Xu, Xu, Uh, Uu, Ur^Es, Ur, Ur, Uu, Cte^Edb, Xu, Cte^Edb, Hhd, Hhd, Md, Md, Md, Md, Md, Md, Md
Xu, Xu, Xu, Xu, Xu, Xu, Xu, Xu, Xu, Xu, Xu, Uh, Uh, Uu, Ur, Ur, Uu, Xu, Xu, Xu, Hhd, Hhd, Hh, Md, Md, Md, Md, Md, Md
