Gs^Fds, Gs^Fds, Gs^Fds, Gs^Fds, Gs^Fds, Gs^Fms, Gs^Fds, Gs^Fms, Gs^Fds, Gs^Fds, Gs^Fds, Gs^Fds, Gs^Fds, Gs^Fds, Gs^Fds, Gs^Fds, Re, Gs^Fds, Gs^Fds, Gs^Fds, Gs^Fds, Gs^Fms, Gs^Fds, Gs^Fds, Gs^Fds, Gs^Fds, Gs^Fds, Gs^Fds, Gs^Fds, Gs^Fds, Gs^Fds, Gs^Fds, Gs^Fds
Gs^Fds, Gs^Fds, Gs^Fds, Gs^Fds, Gs^Fds, Gs^Fds, Gs^Fds, Gs^Fds, Gs^Fds, Gs^Fds, Gs^Fds, Gs^Fds, Gs^Fds, Gs^Fds, Gs^Fds, Gs^Fds, Re, Gs^Fds, Gs^Fds, Gs^Fds, Gg^Fet, Gs^Fds, Gs^Fds, Gs^Fds, Gs^Fds, Gs^Fds, Gs^Fds, Gs^Fms, Gs^Fms, Gg^Efm, Gs^Fds, Gs^Fds, Gs^Fds
Gs^Fds, Gs^Fds, Gg^Efm, Gs, Gs^Fds, Gs^Fds, Ss, Gs^Fds, Gs^Fds, Gs^Fds, Gll^Fp, Gs^Fms, Gs^Fms, Gs^Fds, Gs^Fds, Gs^Fds, Gs^Fds, Gg, Gs^Fms, Gs^Fds, Gs^Fms, Gs^Fds, Gs^Fms, Gs^Fds, Gs^Fds, Gs^Fds, Gs^Fds, Gs^Fms, Gs^Fms, Gs^Fms, Gs, Gs, Gs^Fds
Gg, Gg, Gs^Fms, Gs^Fds, Gs^Fds, Gs^Fds, Ss, Gs^Fds, Gs^Fds, Gs^Fms, Gs^Fms, Gs^Fms, Gs^Fms, Gs^Fms, Gs^Fms, Gs^Fds, Gs^Fds, Gs^Fds, Gs, Gs^Fds, Gg^Vhs, Gs^Fms, Gs^Fds, Gg, Gll^Fp, Gs^Fms, Gs^Fds, Gs, Gs^Fms, Gs^Fms, Gs^Fms, Hh^Fds, Gs^Fds
Gg, Gs^Fms, Gg, Gg, Gs, Gs, Gs^Fds, Gg, Gs^Fms, Gs^Fds, Gs^Fms, Gs^Fms, Gs^Fds, Gs^Fds, Gs^Fds, Gs^Fms, Gs^Fds, Rb, Gs, Gs^Fms, Gs^Fms, Gs^Fms, Gg, Gg^Efm, Gg, Gs^Fds, Hh^Fds, Gs^Fds, Gg, Gg, Hh^Fds, Hh^Fms, Hh^Fms
Gs^Fms, Gs^Fds, Gs^Fms, Gs^Fds, Gg, Gs, Gs^Fms, Gs^Fms, Gs^Fds, Gs^Fms, Gs^Fms, Gs^Fms, Gs^Fms, Gs^Fms, Gs^Fds, Gs^Fms, Gs^Fds, Rb, Gs^Fds, Gs^Fms, Hh^Fds, Gs^Fds, Gs^Fms, Gg, Gs^Fds, Hh^Fds, Hh^Fds, Gs^Fds, Hh^Fds, Hh^Fms, Hh^Fms, Hh^Fms, Hh^Fms
Gs^Fms, Gs^Fds, Gg, Gs^Fms, Gg, Gs, Gs^Fds, Gs^Fms, Gs^Fms, Gs^Fms, Ss, Gs^Fms, Ss, Gs^Fms, Gs^Fms, Gs^Fds, Gs, Re, Gs^Fds, Gs^Fms, Hh, Gs^Fds, Gs^Fms, Gs^Fds, Hh^Fms, Hh^Fds, Hh^Fms, Hh^Fms, Hh^Fms, Hh^Fds, Gs^Fms, Hh^Fds, Hh^Fms
Gs^Fms, Gs^Fms, Gs^Fds, Gs^Fms, Gs^Fds, Gs^Fds, Gs^Fds, Gs^Fds, Gg^Fet, Gs^Fds, Gs^Fms, Gs^Fms, Ss, Gg^Ve, Gs^Fms, Gs^Fms, Gs^Fds, Gs^Fds, Gll^Fp, Gs^Fds, Hh^Fds, Hh^Fds, Hh^Fds, Gs^Fms, Hh, Gs^Fds, Gs^Fds, Hh^Fms, Gs^Fms, Hh^Fms, Hh^Fms, Hh, Hh^Fms
Gs^Fms, Gs^Fds, Gs^Fds, Gs^Fms, Gs^Fms, Gs^Fms, Gs^Fds, Gs^Fms, Gs^Fds, Gs^Fds, Gs^Fms, Ss, Gs^Fms, Gs^Fds, Gs^Fds, Gg^Efm, Rb, Rb, Gs^Fds, Gs^Fds, Hh^Fds, Hh, Hh, Hh, Gs^Fms, Hhd, Hhd, Hh, Hh^Fds, Gs^Fms, Hh^Fds, Hh, Gs^Fms
Gs^Fms, Gs^Fms, Gs^Fms, Gg^Vhs, Gll^Fp, Gs^Fms, Gs^Fms, Gs^Fds, Ss, Gs^Fms, Gs^Fms, Gs^Fms, Gs^Fds, Ss, Gs^Fds, Gg, Re, Gs^Fms, Hh, Hh^Fds, Hh, Gs^Fds, Gg^Fet, Gs^Fds, Hhd, Hhd, Hh^Fds, Gg^Vhs, Gs^Fms, Hh^Fds, Hh^Fds, Hh^Fds, Gs^Fms
Gs^Fms, Gs^Fms, Gs^Fds, Gs^Fds, Gs^Fms, Gs^Fds, Gs^Fms, Ss, Gs^Fds, Gs^Fms, Gs^Fds, Gg, Gs^Fms, Gs^Fms, Gs^Fms, Gs^Fms, Re, Hh, Gs^Fms, Hh, Hh, Hh^Fds, Gs^Fms, Hh, Gs^Fms, Hhd, Hhd, Gs^Fms, Gs^Fms, Hh^Fms, Hh^Fms, Hh^Fds, Gs^Fms
Gs^Fms, Gs^Fms, Gs^Fms, Gs^Fds, Gs^Fms, Gs^Fms, Gs^Fms, Gs^Fms, Gg^Em, Gs^Fms, Gs^Fms, Gs^Fms, Gs^Fms, Gs^Fds, Gs^Fds, Gs^Fds, Gs^Fms, Re, Hh, Hh^Fds, Hh^Fds, Hh, Hh, Hh, Hhd, Hh, Hh^Fds, Hh^Fds, Gs^Fms, Gs^Fms, Gs^Fms, Gs^Fms, Gs^Fms
Gs^Fms, Gs^Fms, Gs^Fms, Gs^Fms, Gs^Fds, Gs^Fms, Gs^Fds, Gg, Gs^Fms, Gs^Fms, Gg, Gs^Fms, Gs^Fms, Gs^Fds, Gs^Fds, Gs^Fms, Gg, Gg, Hh^Fds, Hh^Fds, Hh, Gs^Fds, Hh, Hhd, Hh, Hh^Fds, Gs^Fms, Gs^Fms, Gs^Fms, Gg^Fet, Gs^Fms, Gs^Fds, Gs^Fms
Gs^Fms, Gs^Fds, Gs^Fds, Gg^Em, Gs, Gs, Gg, Gg^Efm, Gg, Gg, Gs^Fms, Gg^Ve, Gs^Fds, Gll^Fp, Gs^Fds, Hh, Hh^Fds, Hh, Hh, Hh, Gs^Fms, Hh, Gs^Fds, Gs^Fds, Hh, Hh^Fds, Gs^Fms, Gs^Fms, Xu, Gs^Fms, Xu, Gs^Fms, Gs^Fds
Gs^Fms, Gs^Fms, Gs^Fds, Gg, Gs^Fms, Gs^Fms, Gs^Fms, Gs^Fms, Gs^Fds, Gg, Gs, Gg, Gs^Fms, Gs^Fms, Hh, Hh, Gs^Fds, Gs, Gs, Rb, Gs^Fms, Gs^Fds, Gg^Vhs, Gs^Fms, Gs^Fms, Hh, Xu, Xu, Uu^Edb, Xu, Uu^Edb, Xu, Gs^Fms
Gs^Fms, Gs^Fms, Gs^Fms, Gg^Vhs, Gs^Fds, Hh^Fds, Hh^Fds, Hh^Fms, Hh^Fms, Gs, Gs^Fms, Gs^Fms, Hh^Fms, Gs^Fms, Gs^Fms, Gs^Fms, Gs^Fds, Gs^Fms, Gg, Rb, Gs^Fds, Gs^Fms, Gs^Fms, Gs^Fms, Gs^Fms, Gs^Fms, Xu, Uu, Uh, Uu^Em, Uu^Edb, Xu, Gs^Fms
Gs^Fms, Gs^Fms, Gs^Fms, Gs^Fms, Gs^Fms, Hh^Fds, Hh^Fds, Hh, Hh, Gs^Fms, Hh^Fds, Hh^Fms, Hh^Fms, Hh^Fms, Hh^Fms, Gg^Fet, Gs^Fms, Gs^Fms, Gs^Fms, Re, Re, Gg^Efm, Gs^Fms, Gs^Fms, Gs^Fms, Gs^Fms, Gll^Fp, Xu, Uu^Edb, Uu^Em, Uh, Xu, Gs^Fms
Gs^Fms, Gs^Fms, Hh^Fms, Hh^Fms, Gll^Fp, Hh^Fms, Gs^Fms, Hh^Fms, Hh, Hh^Fms, Gs^Fms, Gs^Fms, Hhd, Hhd, Gs^Fms, Gs^Fms, Gs, Gs^Fms, Gg, Gg, Gs^Fds, Re, Gs^Fms, Gs^Fms, Gs^Fms, Gs^Fms, Gs^Fms, Rb^Edb, Rb^Edb, Uu^Edb, Xu, Xu, Gs^Fms
Gs^Fms, Hh^Fms, Gs^Fms, Gs^Fms, Hh^Fms, Hh^Fms, Gs^Fms, Hh, Hh, Hh^Fms, Hh, Gs^Fms, Hh^Fms, Hhd, Hhd, Gs^Fms, Gs, Gs^Fms, Gs, Gs^Fms, Gs^Fms, Gs^Fms, Gs^Fms, Gs^Fms, Gs^Fms, Gs^Fms, Gs^Fms, Rb^Edb, Gs^Fms, Rb^Edb, Gg, Gs^Fms, Gs^Fms
Hh^Fp, Hh^Fp, Gs^Fms, Hh^Fms, Gs^Fms, Hh^Fms, Hh^Fms, Hh^Fms, Gs^Fms, Hh, Gs^Fms, Hh, Gs^Fms, Hh^Fms, Hh, Gg^Vhs, Gll^Fp, Gs, Gs^Fms, Gs^Fms, Gg, Gs^Fms, Gg, Rb, Gs^Fms, Gs^Fms, Gs^Fms, Gg^Edb, Gs^Fms, Gs^Fms, Gs^Fms, Gs^Fms, Gs^Fms
Gll^Fp, Gs^Fms, Gs^Fms, Gg^Fet, Gs^Fms, Gs^Fms, Ss, Gs^Fms, Gs^Fms, Hh^Fms, Hh, Gs^Fms, Hh^Fms, Gs^Fms, Hh^Fms, Hh^Fms, Hh^Fms, Gs, Hh^Fms, Gs^Fms, Gg, Gs^Fds, Re, Rb, Gs^Fms, Gs^Fms, Gs^Fms, Gs^Fms, Gg^Efm, Gs^Fms, Gs^Fms, Gs^Fms, Gs^Fms
Gs^Fms, Gs^Fms, Gs^Fms, Gs^Fms, Gs^Fms, Ss, Gs^Fms, Gs^Fms, Gs^Fms, Hh^Fms, Hh, Hh, Gs^Fms, Hh^Fms, Hh, Hh, Hh^Fms, Gs^Fms, Hh^Fms, Gs^Fds, Gg^Efm, Re, Gg^Vhs, Gs^Fms, Gs^Fds, Ss, Ss, Gg, Gs^Fms, Gs^Fms, Gs^Fms, Gs^Fms, Gs^Fms
Gs^Fms, Gs^Fms, Gs^Fms, Gs^Fms, Gs^Fms, Gs^Fms, Gg, Gs^Fms, Gll^Fp, Gg^Vhs, Gs^Fms, Gs^Fms, Gs^Fms, Hh^Fms, Hh^Fp, Hh, Gs^Fms, Gs^Fms, Re, Gg, Gs^Fms, Gs^Fms, Gs^Fms, Gs^Fms, Gg, Gs^Fms, Gs^Fms, Gs^Fms, Gs^Fms, Gs^Fms, Gs^Fms, Gs^Fms, Gs^Fms
Gs^Fms, Gs^Fms, Gg, Gg, Gs^Fms, Gs^Fms, Gs^Fms, Ss, Gs^Fms, Gll^Fp, Gs^Fms, Gll^Fp, Hh^Fms, Hh^Fms, Hh^Fms, Gll^Fp, Gs^Fms, Rb, Gg, Gs, Gs^Fms, Gs^Fms, Gs, Ss, Gs^Fms, Gll^Fp, Gs^Fms, Gs^Fms, Gll^Fp, Gs^Fms, Gg^Fet, Gs^Fms, Gs^Fms
Gs^Fms, Gs^Fms, Gs^Fms, Gg, Gg^Es, Gg, Gg, Gs^Fms, Gs^Fms, Gll^Fp, Gll^Fp, Gs^Fms, Hh, Hh, Gs^Fms, Hh^Fp, Gs^Fms, Rb, Hh^Fms, Gs, Gll^Fp, Gs^Fms, Gs, Gs^Fms, Gs^Fms, Gg, Gg^Efm, Gg, Gs^Fms, Gs^Fms, Gs^Fms, Gs^Fms, Gg
Gll^Fp, Gs^Fms, Gll^Fp, Gs^Fms, Exos^Fp, Gs^Fms, Gg^Es, Gs^Fms, Gs^Fms, Gll^Fp, Ss, Gs^Fms, Gs^Fms, Gg^Ve, Gs^Fms, Gs^Fms, Gs, Rb, Gs^Fms, Hh, Hh^Fms, Hh^Fms, Hh, Hh, Hh^Fp, Hh^Fp, Gg, Gg, Gll^Fp, Gs^Fms, Gs^Fms, Gs^Fms, Gg
Gs^Fms, Gs^Fms, Gs^Es, Exos^Fp, Exos, Exos^Fp, Gs^Es, Gs^Fms, Gs^Fms, Gs^Fms, Gg^Efm, Ss, Gs^Fms, Gll^Fp, Gs^Fms, Gs^Fms, Gs, Gll^Fp, Hh, Hh^Fms, Gs^Fms, Gs^Fms, Hh^Fms, Hh^Fp, Hh^Fms, Hh, Hh^Fms, Hh^Fp, Gll^Fp, Gg, Gs^Fms, Gs^Fms, Gs^Fms
Gll^Fp, Gll^Fp, Gll^Fp, Exos^Fp, Exos^Fp, Exos^Fp, Gll^Fp, Gs^Fms, Gs^Fms, Gll^Fp, Gg, Gll^Fp, Gs^Fms, Gg^Fet, Gll^Fp, Gs^Fms, Hh^Fms, Gs^Fms, Hh^Fds, Hh^Fms, Gs^Fms, Gs^Fms, Hhd, Hh, Gs^Fms, Gs^Fms, Gs^Fms, Gs^Fms, Gs^Fms, Gll^Fp, Gs^Fms, Gs^Fms, Gs^Fms
Gll^Fp, Gll^Fp, Gll^Fp, Gll^Es, Gll^Fp, Gll^Es, Gll^Fp, Gll^Fp, Gs^Fms, Gs^Fms, Gs^Fms, Gs^Fms, Gs^Fms, Gs^Fms, Gs^Fms, Hh, Gs^Fms, Rb, Gg^Efm, Gg^Ve, Hh^Fms, Hhd, Hhd, Hh^Fms, Hh^Fms, Gs^Fms, Gs^Fms, Gg^Vhs, Gll^Fp, Gll^Fp, Gs^Fms, Gs^Fms, Gs^Fms
Ww, Gll^Fp, Ww, Gll^Fp, Gs^Fp, Gll^Fp, Gll^Fp, Gs^Fp, Gs^Fp, Gs^Fp, Gs^Fp, Gll^Fp, Gs^Fms, Gs^Fms, Gs^Fms, Gs^Fms, Gg, Rb, Hh^Fms, Hh^Fms, Hh^Fms, Hh, Hh, Hhd, Hh^Fms, Gs^Fms, Gs^Fms, Gll^Fp, Gs^Fms, Hh^Fp, Hh^Fms, Gs^Fms, Gll^Fp
Gll^Fp, Ww, Gll^Fp, Ww, Wwf, Ww, Ww, Gs^Fp, Gs^Fp, Gs^Fp, Gs^Fp, Gll^Fp, Gll^Fp, Gll^Fp, Gll^Fp, Gll^Fp, Gs^Fms, Re, Re, Hh^Fp, Hh^Fp, Hh, Hh^Fms, Hhd, Hh^Fp, Gs^Fms, Hh^Fp, Hh, Hh, Hh, Hh^Fp, Gs^Fms, Gs^Fms
Gs^Fms, Gs^Fp, Gll^Fp, Gs^Fms, Gs^Fms, Gs^Fp, Gs^Fp, Wwf, Ww, Ww, Ww, Gs^Fms, Gs^Fms, Gg^Vhs, Gll^Fp, Gs^Fms, Ww, Gs^Fms, Ww, Re, Hh, Hh^Fms, Gs^Fms, Hh^Fms, Hh, Gs^Fms, Hhd, Hhd, Hh^Fms, Hh^Fms, Hh^Fms, Hh^Fp, Gll^Fp
Gs^Fms, Gll^Fp, Gll^Fp, Gs^Fms, Gs^Fms, Gs^Fms, Gs^Fms, Gll^Fp, Gs^Fms, Gs^Fp, Gs^Fp, Ww, Ww, Gll^Fp, Ww, Ww, Gs^Fms, Ww, Ww, Hh, Wwf, Re, Gg^Efm, Hh^Fms, Hh, Hh^Fms, Hhd, Hhd, Gll^Fp, Hh^Fms, Hh^Fms, Gs^Fms, Gs^Fms
Gll^Fp, Gll^Fp, Gs^Fms, Gs^Fms, Gll^Fp, Gs^Fms, Gs^Fms, Gs^Fp, Gs^Fms, Gs^Fms, Gs^Fp, Ww, Gs^Fms, Ww, Gll^Fp, Ww, Gs^Fms, Gs^Fms, Gs^Fms, Wwf, Wwf, Re, Gg, Gs^Fms, Hh^Fp, Hh^Fp, Hh^Fp, Hhd, Gs^Fms, Gs^Fms, Gll^Fp, Gs^Fms, Gs^Fms
Gs^Fms, Gll^Fp, Gs^Fms, Gs^Fms, Gll^Fp, Gs^Es, Gll^Es, Gs^Fms, Gll^Fp, Gs^Fms, Gll^Fp, Gll^Fp, Gll^Fp, Gll^Fp, Gs^Fms, Gs^Fms, Gll^Fp, Gg^Vhs, Gs^Fms, Gll^Fp, Re, Wwf, Gg, Gg^Ve, Gs^Fms, Gll^Fp, Gll^Fp, Gll^Fp, Gs^Fms, Gll^Fp, Gs^Fms, Gll^Fp, Gll^Fp
Gs^Fms, Gs^Fms, Gs^Es, Gll^Fp, Gs^Fms, Gll^Fp, Gs^Fms, Gll^Fp, Gs^Fms, Gs^Fms, Gs^Fms, Gs^Fms, Gll^Fp, Gll^Fp, Hh^Fp, Gs^Fms, Gs^Fms, Gll^Fp, Gs^Fms, Gs^Fms, Gll^Fp, Ww, Ww, Gll^Fp, Gll^Fp, Gg^Fet, Gll^Fp, Gll^Fp, Gll^Fp, Gs^Fms, Gg^Em, Gs^Fms, Gll^Fp
Gll^Fp, Gs^Fms, Gs^Fms, Gll^Fp, Hh, Gs^Fms, Gll^Fp, Gs^Fms, Gll^Fp, Gs^Fms, Gll^Fp, Gll^Fp, Hh^Fp, Gll^Fp, Hh, Hh^Fp, Hh, Gs^Fms, Gg^Efm, Re, Gll^Fp, Gll^Fp, Ww, Ww, Gll^Fp, Gll^Fp, Gll^Fp, Gg^Efm, Gg, Gs^Fms, Gll^Fp, Gll^Fp, Gll^Fp
Gs^Fms, Gs^Fms, Gll^Fp, Gs^Fms, Hh, Hh, Hh, Gll^Fp, Gll^Fp, Gll^Fp, Gll^Fp, Gg^Fet, Gs^Fms, Hh^Fms, Hh^Fms, Hh^Fp, Gll^Fp, Hh^Fp, Hh, Re, Hh^Fms, Gll^Fp, Gll^Fp, Ww, Gll^Fp, Gll^Fp, Gll^Fp, Gg, Gg, Gs^Fms, Gg^Ve, Gll^Fp, Gs^Fms
Gll^Fp, Gll^Fp, Hh, Gs^Fms, Gll^Fp, Hh, Gll^Fp, Gll^Fp, Gs^Fms, Gll^Fp, Gll^Fp, Gll^Fp, Gg^Vhs, Hh^Fp, Gll^Fp, Gs^Fms, Gs^Fms, Gg, Re, Re, Hh^Fp, Hh^Fp, Gs^Fms, Ww, Ww, Gll^Fp, Ww, Gg, Gs^Fms, Gg, Gg, Gs^Fms, Gll^Fp
Gll^Fp, Hh, Hh, Gll^Fp, Mm, Gll^Fp, Gs^Fms, Gs^Fms, Gll^Fp, Gs^Fms, Gg, Gg^Efm, Re, Rb, Rb, Gs^Fms, Hh^Fp, Re, Gg^Ve, Gs^Fms, Hh, Gll^Fp, Hh, Gs^Fms, Gs^Fms, Ww, Gll^Fp, Ww, Ww, Gs^Fms, Gll^Fp, Gll^Fp, Gll^Fp
Hh, Hh, Hh, Mm, Hh, Hh, Gll^Fp, Gll^Fp, Gs^Fms, Gll^Fp, Gs^Fms, Re, Gs^Fms, Gll^Fp, Gll^Fp, Gs^Fms, Hh^Fms, Gg, Hh^Fp, Hh^Fp, Hh^Fp, Hh^Fp, Hh, Gll^Fp, Gs^Fms, Ww, Gs^Fms, Gll^Fp, Ww, Gll^Fp, Gll^Fp, Gll^Fp, Gll^Fp
Mm, Hh, Mm, Hh, Hh, Gll^Fp, Gll^Fp, Gs^Fms, Re^Es, Re^Es, Gll^Fp, Gs^Fms, Gll^Fp, Gs^Fms, Gll^Fp, Gs^Fms, Gll^Fp, Gll^Fp, Gll^Fp, Gll^Fp, Gs^Fms, Hh, Gll^Fp, Hh, Gg, Gll^Fp, Gs^Fms, Ww, Ww, Gll^Fp, Gg, Gg^Efm, Gll^Fp
Mm, Mm, Mm, Mm, Ce, Re^Vct, Re^Ecf, Re, Re^Vct, Gs^Fms, Gs^Fms, Gs^Fms, Gll^Fp, Gs^Fms, Hh, Gll^Fp, Gll^Fp, Gs^Fms, Gll^Fp, Gg^Fet, Gll^Fp, Gs^Fms, Gll^Fp, Gll^Fp, Gg^Em, Gs^Fms, Gs^Fms, Gll^Fp, Ww, Gg, Gg, Gg, Gll^Fp
Mm, Mm, Mm, Ce, Ce, Re^Es, Re^Es, Re, Gs^Fms, Gs^Fms, Gs^Fms, Hh, Hh, Hh, Hh, Hh, Hh, Hh, Hh, Gll^Fp, Gs^Fms, Gs^Fms, Gs^Fms, Gll^Fp, Gs^Fms, Gg^Vhs, Gll^Fp, Gll^Fp, Gll^Fp, Ww, Ww, Gll^Fp, Gg
Mm, Mm, Hh, 1 Ke, Hh, Hh, 2 Ke, Ce, Ce, Gll^Fp, Mm, Hh, Mm, Hh, Mm, Hh, Hhd, Hhd, Hhd, Hh, Hh, Hh, Gll^Fp, Gs^Fms, Gll^Fp, Gll^Fp, Gll^Fp, Gll^Fp, Gll^Fp, Gll^Fp, Ww, Ww, Gll^Fp
Mm, Mm, Mm, Hh, Hh, Hh, Mm, Ce, Mm, Mm, Mm, Mm, Mm, Mm, Mm, Mm, Mm, Mm, Hhd, Hhd, Hh, Hh, Hh, Gs^Fms, Gs^Fms, Gll^Fp, Gll^Fp, Gll^Fp, Gll^Fp, Gll^Fp, Gll^Fp, Ww, Ww
Gll^Fp, Mm, Gll^Fp, Hh, Gll^Fp, Mm, Mm, Mm, Mm, Mm, Mm, Mm, Mm, Mm, Mm, Mm, Mm, Mm, Mm, Mm, Mm, Hh, Hh, Hh, Gll^Fp, Gll^Fp, Gll^Fp, Gll^Fp, Gll^Fp, Gll^Fp, Gll^Fp, Ww, Ww
