Gs^Fds, Gs^Fds, Gs^Fds, Gs^Fds, Gs^Fds, Gs^Fds, Gs^Fms, Gs^Fds, Gs^Fds, Gs^Fds, Gs^Fms, Gs^Fms, Gs^Fds, Gs^Fds, Gs^Fds, Gs^Fds, Gs, Gs^Fds, Gs^Fds, Gs^Fds, Gs^Fds, Gs^Fds, Gs^Fds, Gs^Fds, Gs^Fds, Gs^Fds, Hh, Gll^Fp, Hh^Fds, Hh^Fds, Mm, Mm, Mm
Gs^Fds, Gs^Fds, Gs^Fms, Gs^Fds, Gs^Fds, Gs^Fms, Gs^Fms, Gs^Fms, Gs^Fms, Gs^Fms, Gs^Fds, Gs^Fms, Gs^Fms, Gs^Fds, Gs^Fds, Gs^Fds, Gs, Gs^Fds, Gs^Fds, Gs^Fds, Gs^Fds, Gs^Fds, Gs^Fds, Gs^Fds, Gs^Fds, Gs^Fds, Hh^Fds, Hh, Hh^Es, Mm, Hhd, Hh^Vhh, Mm
Gs^Fds, Gs^Fds, Gs^Fds, Gs^Fms, Gs^Fms, Gs^Fms, Gs^Fds, Gs^Fms, Gs^Fms, Gs^Fms, Gg, Gs^Fds, Gs, Gs^Fds, Gs, Gs^Fds, Gs^Fms, Gs^Fds, Gs^Fms, Gg^Ve, Gs^Fds, Gs^Fds, Hh^Fds, Hh, Hh, Hh, Hh, Hh, Hhd^Es, Hhd, Mm, Mm, Mm
Gs^Fds, Gs^Fds, Gs^Fds, Gs^Fms, Gs^Fms, Gs^Fds, Gs^Fds, Gs^Fms, Gs^Fms, Gs^Fms, Gs^Fds, Gg^Efm, Gs^Fds, Gs^Es, Gs^Fds, Gs^Fds, Gs^Fds, Gs^Fds, Gg^Efm, Gs^Fms, Gs^Fms, Gs^Fds, Gs^Fds, Hh^Fds, Hh, Hh^Es, Hh^Es, Mm, Mm, Hhd^Es, Mm, Mm, Mm
Gs, Gs^Efm, Gs^Fds, Gg^Fet, Gs^Fds, Gs^Fds, Gs^Fds, Gs^Fds, Gs^Fds, Gs^Fms, Gs^Fms, Gg^Ve, Gs^Fms, Gs, Gs^Fds, Gg^Fet, Gs^Fds, Gs^Fds, Gs^Fds, Gs^Fms, Gs^Fms, Gs^Fds, Gs^Fds, Gs^Fds, Hh, Hhd^Es, Mm, Mm, Mm, Mm, Mm, Mm, Mm
Gs^Fds, Gs, Rp, Gs^Fds, Gs^Fds, Gs^Fds, Rp, Gs, Gs^Fds, Gs^Fms, Gs^Fms, Gs^Fms, Gs^Fds, Gs^Fds, Ss, Gs^Fds, Gs^Fds, Gs^Fds, Gs, Gs, Gs^Fds, Gs^Fds, Hh, Hh^Fds, Hh^Es, Hhd, Mm, Mm, Mm, Mm, Mm, Mm, Wo
Gs^Fds, Gs^Fds, Gs^Fds, Rp, Gs^Fds, Rp, Gs^Fds, Rp, Gs^Fds, Gs^Fds, Gs^Fms, Gs^Fms, Gs^Fds, Gs^Fds, Gs^Fds, Gs^Fds, Gs^Fds, Gs^Fds, Gs^Fds, Gs^Fds, Gs^Fds, Gs^Fds, Hh^Es, Hh^Es, Mm, Mm, Mm, Mm, Mm, Mm, Mm, Wo, Wo
Gs^Fds, Gs^Fds, Gs^Fds, Gs^Fds, Gs^Fds, Gs^Fds, Gs, Gs^Efm, Gs, Gs^Fds, Gs^Fms, Gs^Fds, Gs^Fds, Gs^Fds, Gs^Fms, Gs^Fds, Gs^Fds, Gs^Fds, Gs^Efm, Gs, Gs^Fds, Hh^Fds, Hh, Hh, Mm, Mm, Gs^Fds, Mm, Ww, Mm, Ww^Es, Wo, Wo
Gs^Fds, Gs^Fds, Gs^Fds, Gs^Fds, Gs^Fds, Gs^Fds, Gs^Fds, Gs^Fds, Gs^Fds, Gs^Fds, Gs^Fds, Gs^Fms, Gs^Fms, Gs^Fms, Gs^Fds, Gs^Fds, Ss^Vhs, Gs^Fds, Gs, Gs^Fds, Gs^Fds, Hh, Hh, Hh, Ww^Es, Gs^Fds, Ww, Ww, Wo, Ww^Es, Wo, Wo, Ww
Gs^Fds, Gs^Fds, Gs^Fds, Gs^Fds, Gs^Fds, Gs^Fms, Gs^Fds, Ss, Ss, Gs^Fds, Rp, Gg^Fet, Gs^Fds, Gs^Fds, Ss, Ss, Gs^Fms, Gs^Fds, Gs^Fds, Gs^Fds, Gs^Fds, Gs^Fds, Hh, Wwf^Es, Wwg^Es, Ww, Ww, Wo, Ww, Wo, Ww, Ww, Mm
Gs^Fds, Gs^Fds, Ss, Ss^Vhs, Gs^Fms, Gs^Fms, Gs^Fds, Gs^Fds, Gs^Fds, Gs^Fds, Gs^Fds, Rp, Gs^Fds, Gs^Fms, Ss, Ss, Gs^Fms, Gs^Fds, Ss, Gs^Fds, Gs^Fds, Gs^Fds, Ww, Ww, Wwg^Es, Wwf^Es, Hh, Ww, Hh, Ww, Mm, Mm, Mm
Gs^Fds, Gs^Fds, Ss, Ss^Em, Gs^Fds, Gs^Fms, Gs^Fms, Gs^Fms, Gs^Fms, Gs^Fds, Gs^Fds, Rp, Gs, Gs^Fms, Gs^Fds, Ss, Gg, Gs^Fds, Ss, Gs^Fds, Gs^Fds, Gs^Fds, Gs^Fds, Wwg, Wwg, Ww, Ww, Hh, Hh, Mm, Hhd, Mm, Hh
Gs^Fds, Ss, Ss, Ss^Em, Gs^Fms, Ss, Ss, Gs^Fds, Gs^Fms, Gs^Fds, Gs^Fds, Gs, Gs^Fms, Gs^Fms, Gs^Fms, Gg, Gs^Fds, Gs^Fds, Gs^Fds, Gs^Fds, Ww^Ewl, Gs^Fds, Ww, Wwg^Es, Ww, Gs^Fds, Hh, Hh, Hh, Hhd, Hh, Hh, Hh
Gs^Fds, Gs^Fms, Gs^Fms, Gs^Fms, Gs^Fms, Gs^Fds, Gs^Fds, Gs^Fms, Gs^Fds, Gg^Fet, Gs^Fds, Gs^Fds, Gs^Fds, Gs^Efm, Gs^Fms, Gs^Fds, Ww, Gs^Fds, Ww, Gs^Fds, Ww, Ww, Ww, Wwg, Gs^Fds, Gs^Fds, Gs^Fds, Re^Es, Gs^Vhs, Hh, Re^Es, Hh, Gs^Fds
Gs^Fds, Gs^Fds, Ss, Gs^Fms, Gs^Fds, Gs^Fds, Gs^Fms, Gs^Fds, Ss, Gs^Fds, Gs^Fds, Rp, Gs^Fds, Gs^Fds, Gs^Fms, Gs^Fds, Ww, Ww, Wwg, Ww^Es, Ww, Ww, Gs^Fds, Ww, Gs^Fds, Gs^Fds, Gs^Fds, Gs^Fms, Gs^Fds, Re^Es, Gs^Fds, Gs^Fds, Gs^Fds
Ww, Ss, Ss, Gs^Fds, Ss, Gs^Fds, Ss, Ss^Vhs, Ss^Em, Gs^Fds, Gs, Rp, Rp, Gs^Fds, Ww, Ww, Ww, Wwg, Cv, Wwg, Gs^Fds, Ww, Gs^Fds, Gs^Fds, Gs^Fms, Gg^Fet, Gs^Fms, Gs^Fds, Gs^Fds, Gs^Fds, Re, Gs^Fds, Gs^Fds
Ww, Ss, Gs^Fds, Ss, Ss, Ss, Ss^Em, Ss^Em, Ss^Em, Ss^Em, Ww, Gs^Fds, Ww, Rp, Ww^Bsb\, Ww, Gs^Fds, Ww, Ww^Bsb|, Ww, Gs^Fds, Gs^Fds, Gs^Fds, Gs^Fms, Gs^Fms, Gs^Fms, Gs^Fms, Gs^Fds, Gs^Fds, Gs^Fds, Re, Gs^Fds, Gs^Fds
Ss, Gs^Fds, Gs^Fms, Gs^Fms, Gs^Fms, Gs^Fds, Ss^Em, Ss^Em, Ss^Em, Gs^Fms, Ww, Ww, Ww, Ww, Ww, Rp, Rp, Rp^Ve, Rp, Rp^Ve, Rp, Gs^Fds, Gs^Efm, Gs^Fds, Gg^Ve, Gs^Fds, Gs^Fms, Gs^Fds, Gs^Fds, Gg, Gs^Fds, Gs^Fms, Gs^Fds
Ss, Ss, Ss, Gs^Fds, Gs^Fds, Gs^Fms, Ss, Ss, Gs^Fms, Gs^Fms, Ww, Wo, Ww, Ww, Gs^Fds, Gs^Fds, Cv, Rr, 3 Kv, Rr, Cv, Gs, Gs^Fds, Gs, Gs^Fds, Gs^Fds, Gs, Gs^Fds, Gg^Ve, Gg, Gs^Fds, Gs^Fms, Gs^Fds
Ss, Gs^Fds, Ss, Ss^Em, Ss, Gs^Fms, Ss, Gs^Fms, Gs^Fds, Gs^Fms, Ww, Wo, Wo, Ww, Gs^Fds, Gs^Fds, Cv, Rr, Cv, Rr, Cv, Gs^Fds, Gs^Fds, Gs^Fds, Gs^Fms, Gs^Fds, Gs^Fds, Gs, Gs^Fds, Gs^Fds, Gs^Fds, Gs^Fms, Gs^Fds
Ss, Gs^Fds, Ss^Vhs, Ss^Em, Ss^Em, Gs^Fds, Ss, Gs^Fds, Gs^Fds, Ss^Vhs, Ww, Wwr, Wo, Gs^Fds, Gs^Fds, Gs^Fds, Gs^Fds, Cv, Rp, Cv, Gs^Fds, Gs^Fds, Gs^Fds, Gg^Fet, Gs^Fms, Gs^Fds, Gs^Fds, Gs, Gs, Gs^Fds, Gs^Fds, Gs^Fds, Gs^Fms
Ss, Ss, Ss^Em, Ss, Ss, Ss, Ss^Em, Ss^Em, Ss, Ss^Em, Gs^Fds, Ww, Wwg, Ww^Es, Ww^Es, Ww, Gs^Fds, Gs^Fds, Rp, Gs^Fds, Gs^Efm, Gs^Fds, Gs, Gs^Fds, Gs^Fds, Gs^Fms, Gs^Fds, Gs^Fds, Gg^Vhs, Gs^Fds, Gs^Fms, Gs^Fms, Gs^Fms
Ss, Ss, Gs^Fms, Ss, Gs^Fms, Gs^Fms, Gs^Fds, Ss^Em, Ss^Em, Gs^Fds, Gs^Fds, Ww, Ww, Wwg, Wwg, Ww, Ww, Gs^Ve, Rp, Gs, Gs^Fds, Gs, Gs^Fds, Gg^Vhs, Gs, Gs^Fds, Gs^Fds, Gs^Fds, Gs, Gs^Fds, Gs^Fms, Gs^Fms, Gs^Fds
Gs^Fds, Gs^Fds, Gs^Fms, Ss, Gs^Fms, Gs^Fds, Gs^Fds, Ss, Ss, Gs^Fds, Gs^Fms, Gs^Fds, Ww, Wwr, Wwg, Wwg, Wwg^Bsb/, Ww^Bsb/, Ww, Ww, Ww, Gs^Fds, Gs^Fds, Gs^Fds, Gg, Gs^Fds, Gs^Fds, Gs^Fds, Gg^Efm, Gs^Fds, Gg^Fet, Gs^Fds, Gs^Fds
Gs^Fms, Gs^Fms, Gs^Fds, Gs^Fds, Gs^Fms, Gs^Fds, Gs^Fds, Gg^Ve, Gs^Fds, Gs^Fds, Gs^Fds, Gs^Fms, Gs^Fds, Ww, Ww^Bsb/, Wwg^Bsb/, Ww, Wwg, Wwr, Ww^Es, Ww, Gs^Fds, Gs^Fds, Gs^Fds, Gs^Fms, Gs, Gs^Fds, Gg, Gs^Fds, Gs^Fms, Gs^Fms, Gs^Fms, Gs^Fds
Gs^Fms, Gs^Fds, Gs^Fds, Gg^Fet, Gs^Fms, Gs^Fms, Gs^Fms, Gs^Fds, Gs^Fds, Gs^Efm, Gs^Fds, Gs^Fds, Re, Re, Gg^Ve, Ww^Ewf, Ww, Ww, Ww, Ww, Ww, Gs^Fds, Gs^Fds, Gs^Fms, Gs^Fms, Gs^Fds, Gs, Gg^Ve, Gs^Fds, Gs^Fms, Gs^Fms, Gs^Fms, Gs^Fds
Gs^Fds, Gs^Fms, Gs^Fms, Gs^Fds, Gs^Fds, Gs^Fms, Gs^Fds, Gs^Fds, Ce, Gs^Fds, Gs, Gs^Fds, Re, Gs, Gs^Fds, Gs^Fds, Gs^Fds, Gs^Fds, Gs^Fds, Ww, Gs^Fds, Ww, Gs^Fds, Gs^Fds, Gs^Fms, Gs^Fds, Gs, Gs^Fds, Gs^Fds, Gs^Fds, Gs^Fms, Gs^Fms, Gs^Fds
Gs^Fds, Gs^Fds, Gs^Fds, Gs^Fds, Gs^Fds, Gg, Gg, Ce, 1 Ke, Ce, Gs^Es, Re, Gs, Gs^Efm, Gs^Fds, Gs^Fds, Gs^Fds, Gs^Fds, Gs^Fds, Ww, Ww, Ww, Ww, Ww, Gs^Fds, Gs^Fms, Gs^Fds, Gg, Gg^Efm, Gs^Fds, Gs^Fms, Gs^Fms, Gs^Fms
Gs^Fms, Gs^Fds, Gs^Fds, Gs^Fds, Gs^Fds, Gs^Fds, Gs, Gs^Fds, Ce, Gs^Es, Rb, Re, Gs, Ce, Ce, Gs^Fms, Gs^Fms, Gs^Fms, Gs^Fds, Gg^Ve, Gs^Fds, Ww, Wo, Ww, Ww, Gg^Fet, Gs^Fds, Gs^Fds, Gs, Gs^Fds, Gs^Fds, Gs^Fms, Gs^Fms
Gs^Fms, Gs^Fms, Gs^Fds, Gg^Ve, Gs^Fds, Gs^Fds, Gs^Fds, Gs^Fds, Gs^Fds, Gs^Efm, Rb, Gs, Ce, 2 Ke, Gs^Fds, Gs^Fds, Gg^Fet, Gs^Fms, Gs^Fds, Gs^Fds, Ww, Ww, Ww, Wo, Ww, Gs^Fms, Gs^Fms, Gs^Fds, Gs^Fds, Gs^Fds, Gs^Fds, Gs^Fds, Gg
Gs^Fds, Gs^Fms, Gs^Fds, Gs^Fds, Gs^Fms, Gs^Fms, Gs^Fds, Gs^Fds, Gs^Fds, Rb, Gs^Fds, Gs^Fds, Gs^Fds, Ce, Gs^Es, Gs^Fds, Gs^Fds, Gs^Fms, Gs^Fms, Gs^Fds, Gs^Fds, Ww, Ww, Wo, Wo, Ww, Gs^Fds, Gs^Fds, Gs^Fds, Gs, Gg^Ve, Gg, Gs^Fds
Gs^Fds, Gs^Fms, Gs^Fms, Gs^Fds, Gs^Fms, Gs^Fds, Gs^Fds, Gs^Fds, Gs^Fds, Rb, Gs^Fds, Gs^Fds, Gs^Fds, Gs^Fds, Gs, Gs^Efm, Gs^Fds, Gs^Fds, Gs^Fms, Gs^Fds, Gs^Fds, Ww, Wo, Wo, Ww, Ww, Gs^Fds, Gs^Fds, Gs^Fds, Gs^Fds, Gs^Fds, Gs^Fds, Gs^Fds
Gs^Fds, Gs^Fds, Gs^Fms, Gs^Fms, Gs^Fms, Gs^Fds, Gs^Fds, Gs^Fds, Gs^Fds, Re, Gs^Fds, Gs^Fds, Gs^Fds, Gs, Gs, Gs, Gs^Fds, Gs^Fms, Gs^Fds, Gs^Fds, Gs^Fds, Ww, Wo, Wo, Ww, Ww, Gs^Fds, Gs^Fds, Gs^Fds, Gs^Fds, Gs^Fds, Gs^Fds, Gs^Fds
