Gs^Fds, Gs^Fds, Gs^Fds, Gs^Fds, Gs^Fds, Gs^Fds, Gs^Fds, Gs^Fds, Gs^Fms, Gs^Fms, Gs^Fms, Gs^Fds, Gs^Fds, Gs^Fms, Gs^Fds, Gs^Fds, Gs^Fds, Gs^Fds, Hh^Fds, Hh^Fds, Hh^Fds, Hh^Fds, Hh^Fds, Hh, Hh, Hh, Hh^Fds, Hh^Fds, Hh^Fds, Hh^Fds, Mm, Mm, Mm, Mm, Mm, Mm, Mm, Mm, Xu, Xu, Uu, Re, Uu, Uu, Uu, Xu, Xu, Xu, Xu, Xu, Xu, Xu, Xu, Xu, Xu, Xu, Xu, Xu, Xu, Xu, Xu, Xu, Xu, Xu, Xu, Xu, Xu
Gs^Fds, Gs^Fds, Gs^Fmw, Gs^Fds, Gs^Fds, Gs^Fds, Gs^Fp, Gs^Fds, Gs^Fms, Gs^Fms, Gs^Fds, Gs^Fds, Gg^Ve, Gs^Fds, Gs^Fds, Gs^Fds, Gs^Efm, Gs^Fds, Hh^Fds, Hh^Fds, Gs^Fds, Gs^Fds, Gs^Fds, Hh^Fds, Hh^Fds, Hh^Fds, Gs^Fds, Gs^Fds, Hh, Hh^Fds, Mm, Mm, Mm, Mm, Mm, Mm, Mm, Mm, Xu, Xu, Uu, Re, Cte, Cte, Cte, Xu, Uu^Vu, Xu, Re, Xu, Xu, Xu, Xu, Xu, Xu, Xu, Xu, Xu, Xu, Xu, Xu, Xu, Xu, Xu, Xu, Xu, Xu
Gs^Fds, Gs^Fds, Gs^Fds, Gs^Fds, Gg^Ve, Gs^Fds, Gs^Fms, Gs^Fms, Gg^Fet, Gs^Fms, Gs^Fms, Ss, Gs^Fds, Gs^Fds, Gs^Fms, Gs^Em, Gs^Fms, Gs^Fds, Gs^Fds, Gs^Fds, Gs^Fds, Gs^Fds, Gs^Fds, Hh^Fds, Gs^Fmw, Gs^Fds, Gs^Fds, Hh^Fds, Gs^Fds, Mm, Gs^Fds, Mm, Mm, Mm, Mm, Mm, Xu, Xu, Xu, Xu, Uu^Vu, Uu, Cte, 4 Kte, Cte, Cte, Uh, Uu, Uu^Ii, Re^Es, Re, Re, Uh, Uh, Uh, Xu, Uu^Vu, Xu, Xu, Xu, Xu, Xu, Xu, Xu, Xu, Xu, Xu
Gs^Fds, Gs^Fp, Gs^Fds, Gs^Fds, Gs^Fds, Gs^Fds, Gs^Fms, Gs^Fds, Ss, Gs^Fms, Gs^Fds, Ss, Ss, Gs^Fms, Gs^Fms, Gs^Fms, Gs^Fds, Gs^Fds, Gs^Fds, Ss, Gs^Fms, Gs^Fms, Gg^Fet, Gs^Fms, Ss, Gs^Efm, Gs^Fp, Gs^Fds, Gs^Fds, Gs^Vl, Gs^Fds, Gs^Fds, Mm, Mm, Mm, Mm, Xu, Xu, Xu, Uu, Uu, Re, Re, Cte, Re, Uu, Uu^Vu, Uh, Uu^Ii, Uu, Uu^Vu, Re, Uh, Uh, Uh, Re^Es, Re^Es, Uu, Re^Es, Uh, Uh, Xu, Xu, Xu, Xu, Xu, Xu
Gs^Fds, Gs^Fds, Gs^Fds, Gs^Fmw, Gs^Fds, Gs^Fds, Gs^Fp, Gs^Fms, Gs^Fds, Gs^Fds, Gs^Fds, Gs^Fds, Gs^Fds, Gs^Fmw, Gs^Fms, Gs^Fms, Gs^Fms, Gg^Vhs, Gs^Fms, Gs^Fds, Gs^Fp, Gs^Fms, Gs^Fmw, Gs^Fms, Ss, Gs^Fms, Gs^Fms, Gs^Fds, Gs^Fds, Gs^Fds, Gs^Fds, Mm, Gs^Fds, Mm, Mm, Xu, Xu, Xu, Uu^Vu, Uu, Xu, Uu, Uu, Re, Uu, Uu, Xu, Xu, Xu, Uu^Ii, Uh^Es, Uh, Xu, Xu, Xu, Xu, Xu, Re, Xu, Re, Uu, Uh, Uh, Xu, Xu, Xu, Xu
Ww, Gs^Fds, Ww, Ww, Ww, Gs^Fds, Gs^Fds, Gs^Fds, Gs^Fds, Ww, Ww, Ww, Wwf, Gs^Fds, Gs^Fms, Gs^Fms, Gs^Fds, Gs^Fms, Gs^Fds, Gs^Fp, Gs^Fds, Gs^Fds, Gs^Fms, Gs^Fds, Gs^Fms, Gs^Fms, Rr, Rr, Rr, Rr, Rr, Gs^Fds, Gs^Fds, Gs^Fds, Xu, Xu, Xu, Xu, Xu, Uu, Xu, Xu, Uu, Re, Re, Xu, Xu, Xu, Re^Ii, Re, Re^Es, Re, Re, Re^Ii, Uu^Ii, Xu, Xu, Xu, Xu, Uu, Uu, Uh, Xu, Xu, Xu, Xu, Xu
Gs^Fds, Ww, Gs^Fds, Gs^Fds, Gs^Fds, Wwf, Ww, Ww, Ww, Ww, Gs^Fms, Ww, Gs^Fds, Ww, Ww, Ww, Ww, Ww, Gs^Fds, Gs^Fms, Gs^Fms, Gs^Fds, Gs^Vl, Gs^Fds, Rr, Rr, Gs^Fms, Gs^Fms, Gs^Fds, Gs^Fds, Gs^Fds, Rr, Rr, Uu, Uu, Xu, Xu, Xu, Xu, Uu, Uu^Vu, Uu, Xu, Xu, Xu, Uu, Uu, Re^Ii, Uu, Uu, Xu, Re, Xu, Re, Re, Uu^Ii, Uu, Uu, Re^Es, Uu, Uh, Uh, Xu, Xu, Xu, Xu, Xu
Gs^Fds, Gs^Fds, Gs^Fds, Gs^Fds, Gs^Fds, Ww, Gs^Fds, Gs^Fds, Gs^Fds, Ww^Ewf, Gs^Fds, Gs^Fms, Gs^Fms, Gs^Fds, Gs^Fms, Ww, Gs^Fms, Ww, Wwf, Gs^Fms, Gs^Fds, Gs^Fds, Rr, Rp, Wwf, Wwf, Gs^Fds, Gs^Fds, Mm, Mm, Gs^Fds, Gs^Fds, Uu, Ur, Ur, Uu^Tf, Uu, Uu^Vud, Uu, Xu, Xu, Xu, Xu, Xu, Xu, Xu, Xu, Xu, Xu, Xu, Uu^Vud, Xu, Xu, Xu, Uu^Ii, Uu, Re, Re^Es, Uu^Vu, Uu, Xu, Uh, Xu, Xu, Uu^Vud, Xu, Xu
Gs^Fds, Gs^Fds, Gs^Fds, Gg^Ve, Gs^Fds, Gs^Fds, Gs^Fms, Gs^Fmw, Gs^Fds, Gs^Fds, Gs^Fds, Gs^Fds, Gs^Efm, Gs^Fds, Gs^Fds, Gs^Fp, Gs^Fms, Gs^Fds, Ww, Ww, Gs^Fds, Gs^Fms, Rr, Wwf, Ww, Ww, Wwf, Wwf, Mm, Mm, Xu, Uu, Uh, Uu, Ur, Uu, Cud, Uu, Uu^Es, Uu, Uu^Tf, Xu, Uh, Xu, Xu, Xu, Uu^Vud, Xu, Xu, Uu, Uu, Uu^Vud, Xu, Xu, Xu, Re, Uu, Xu, Xu, Xu, Xu, Xu, Xu, Uu, Uu, Uu^Vud, Xu
Gs^Fds, Gs^Fds, Gs^Fds, Gs^Fds, Gs^Fds, Gs^Fmw, Gs^Fms, Gs^Fds, Gs^Fds, Gs^Fds, Gs^Fds, Gs^Fms, Gs^Fms, Gs^Fds, Gs^Fms, Gs^Fms, Gs^Fds, Ww, Ww, Gs^Fds, Rr, Rp, Ww, Ww, Wwg, Ww, Ww, Mm, Ww, Xu, Xu, Xu, Xu, Uu, Ur, Cud, Cud, Kud, Uu, Uu^Em, Uu^Em, Uu, Ur, Uh, Uu, Uu, Ur, Uu, Uh, Uu, Xu, Xu, Uu, Uu^Tf, Uu, Xu, Xu, Xu, Xu, Xu, Ur, Xu, Ur, Ur, Xu, Xu, Xu
Ce, Ce, Ce, Ce, Gs^Fds, Gs^Fms, Gs^Efm, Gs^Efm, Gs^Fds, Gg^Vhs, Gs^Fds, Hh^Fds, Gs^Fds, Gg^Fet, Gs^Fms, Gs^Fms, Gs^Fds, Gs^Fms, Rr, Ww^Bsb/, Ww, Ww, Wwg, Ww, Wwg, Ww, Ww^Es, Ww, Ww^Ewf, Uu, Uu, Xu, Uu, Uu^Vud, Ur, Cud, Ur, Cud, Ur, Ur, Ur^Es, Ur, Uu, Ur, Ur, Ur^Es, Uu, Ur, Ur, Uh, Uu, Uu^Vud, Ur, Ur, Ur, Uh, Uu^Vud, Xu, Ur, Ur, Xu, Ur, Ur, Xu, Xu, Xu, Xu
Ce, Ce, 3 Ke, Ce, Gs^Fds, Gs^Fms, Gs^Fms, Gs^Fms, Gs^Fds, Hh^Fds, Hh^Fds, Hh^Fds, Gs^Fds, Gs^Fds, Re, Gs^Fp, Re, Rr, Rp, Ww, Ww, Ww^Es, Wwg, Wwg, Wwg, Ww, Wwg, Wwg, Ww, Uu, Uu^Tf, Uu^Em, Uu^Vud, Uu^Em, Ur, Ur, Uu, Ur, Uu, Uu^Em, Uu, Uh, Xu, Uu, Uu^Vud, Uu, Xu, Uu, Uu, Ur^Es, Ur^Es, Ur, Uu^Tf, Uu, Uu, Ur, Ur, Ur, Uu, Xu, Xu, Xu, Ur, Uu^Vud, Uu, Xu, Xu
Ce, Ce, Ce, Ce, Gs^Fds, Gs^Fp, Gs^Fds, Gs^Fds, Hh^Fds, Hh^Fds, Hh^Fds, Hh^Fds, Gs^Fds, Gs^Fds, Gs^Fp, Re, Gs^Fms, Gs^Fds, Rp, Ww, Wwf, Ww, Ww, Wwg, Wwg, Wwg, Wwg, Wwg, Xu, Xu, Uu^Tf, Uu^Em, Uu^Em, Uu, Ur, Cud, Cud, Cud, Uh, Uu, Xu, Xu, Xu, Xu, Xu, Xu, Xu, Xu, Xu, Uu, Uh, Uu, Xu, Xu, Uu, Uu, Uu, Ur, Ur, Uh, Xu, Uu^Vud, Uu, Ur, Uu, Uu^Vud, Xu
Gs^Fms, Ce, Gs^Fms, Ce, Gs^Fds, Gs^Fds, Gs^Fp, Gs^Fds, Hh^Fds, Hh^Fds, Hh^Fds, Gs^Fds, Gs^Fds, Gs^Fds, Hh^Fds, Gs^Fms, Gs^Fds, Gs^Fds, Gs^Fds, Rp, Wwf, Ww, Wwg, Wwg, Ww, Ww, Ww, Ww, Xu, Xu, Xu, Uu, Ur, Ur^Es, Uu^Tf, Cud, Cud, Kud, Uu, Uh, Uh, Xu, Xu, Xu, Uu, Uu^Vu, Uu, Xu, Xu, Xu, Xu, Xu, Xu, Uu^Vud, Uu^Vud, Uu, Xu, Uh^Es, Ur, Uh, Uh, Xu, Xu, Uu^Vud, Xu, Xu, Xu
Gs^Fms, Gs^Fms, Gs^Fms, Gs^Fds, Gs^Fds, Gg^Ve, Gs^Fds, Gs^Fds, Gs^Fds, Hh^Fmw, Hh^Fds, Hh^Fds, Gs^Fds, Gs^Fds, Hh^Fds, Hh^Fds, Gs^Efm, Gs^Fp, Gs^Fds, Rp, Wwf, Ww, Ww, Ww^Es, Ww, Ww, Wwf, Mm, Mm, Xu, Gs^Fds, Rr, Gs^Fds, Uu, Uu, Uu, Uu, Uu, Uu^Vud, Uh, Xu, Xu, Xu, Uu, Xu, Xu, Uu, Re^Es, Re, Xu, Uu^Vu, Xu, Xu, Xu, Xu, Xu, Xu, Uu^Vud, Uu, Ur, Ur, Uu^Tf, Uu, Xu, Uu^Vud, Uu, Uu
Gs^Fms, Gs^Fms, Gs^Fp, Gs^Fmw, Gs^Fds, Gs^Fds, 1 Hh^Fp, Gs^Fms, Hh^Fds, Gs^Fds, Hh^Fds, Hh^Fds, Gs^Fds, Hh^Fds, Hh^Fds, Hh^Fds, Gs^Fp, Gs^Fms, Gs^Fds, Rr, Rr, Gs^Fds, Gs^Fds, Ww, Gs^Fds, Wwf, Mm, Mm, Mm, Gs^Fms, Gs^Fds, Rr, Gs^Fms, Gs^Fds, Gs^Fds, Xu, Xu, Xu, Xu, Xu, Xu, Xu, Xu, Re, Uu, Xu, Uh, Xu, Xu, Uu, Re, Uu, Uu^Ii, Uu^Vu, Xu, Xu, Xu, Xu, Xu, Uu, Uu, Ur, Ur^Es, Uu, Ur, Ur, Ur
Hh^Fds, Gs^Fds, Gs^Fds, Gs^Fms, Hh^Fms, Hh^Fms, Mm, 2 Hh^Fds, Gs^Fds, Hh^Fds, Gs^Fds, Gs^Fds, Gs^Fmw, Gs^Fds, Hh^Fds, Gs^Fds, Gs^Fms, Gs^Fms, Ss, Gs^Fds, Gs^Fds, Rp, Gs^Vl, Gs^Fds, Gs^Fmw, Gs^Fds, Gs^Fds, Gs^Fds, Gs^Fds, Gs^Fds, Rr, Rr, Gs^Fmw, Gs^Fms, Mm, Mm, Mm, Xu, Xu, Xu, Uu^Vu, Uh, Uh, Re^Es, Re^Es, Uh, Uh, Xu, Xu, Xu, Re, Uu^Ii, Uh, Uh, Xu, Xu, Xu, Uu, Re^Es, Xu, Xu, Uh, Uh, Ur, Uu, Uu, Uu
Hh^Fds, Hh^Fds, Mm, Gg^Fet, Mm, Mm, Mm, Hh^Fms, Gs^Fds, Hh^Fds, Gs^Fds, Gs^Fds, Gs^Fds, Gs^Fds, Gs^Fds, Gs^Fp, Gs^Fms, Gs^Fms, Gs^Fds, Gs^Fms, Gs^Fmw, Rp, Rr, Gs^Fds, Gs^Fds, Gs^Fms, Rp, Gs^Fds, Rp, Rp, Gs^Vl, Gs^Fms, Gs^Fp, Gs^Fds, Mm, Mm, Mm, Xu, Xu, Xu, Xu, Uu, Uu, Re, Re^Es, Re, Uu^Ii, Uu^Ii, Re^Es, Re^Es, Xu, Xu, Uu^Vu, Uh, Re, Xu, Uu^Ii, Re^Es, Uu^Ii, Uu^Ii, Xu, Xu, Xu, Uh, Xu, Xu, Xu
Hh^Fds, Mm, Mm, Mm, Mm, Mm, Hh^Fp, Gs^Fmw, Gs^Fds, Gs^Fds, Gs^Fds, Gg^Vhs, Gs^Fds, Gs^Fp, Gg^Fet, Gs^Fds, Hh^Fds, Gg^Ve, Gs^Fds, Gs^Fms, Ss, Gs^Fms, Gs^Fds, Rr, Rr, Rr, Gs^Fds, Rp, Gs^Fds, Gs^Fds, Gs^Fds, Gs^Fp, Gs^Fds, Mm, Mm, Mm, Mm, Xu, Xu, Xu, Xu, Uu^Vu, Cte, Cte, Cte, Xu, Xu, Xu, Uu, Re, Uh, Xu, Xu, Uh, Re^Es, Uu, Uu, Re, Uu, Uu, Xu, Xu, Xu, Xu, Xu, Xu, Xu
Mm, Mm, Mm, Mm, Mm, Mm, Hh^Fmw, Hh^Fms, Hh^Fms, Gs^Fds, Gs^Fms, Gs^Fds, Gs^Fms, Gs^Fds, Gs^Fds, Hh^Fms, Gs^Fmw, Gs^Fds, Gs^Fds, Ss, Gs^Fms, Gs^Fms, Gs^Fds, Gs^Fp, Gs^Fds, Gs^Fms, Hh^Fds, Gs^Fds, Hh^Fds, Gs^Fds, Mm, Hh^Fds, Hh, Hh, Mm, Mm, Mm, Mm, Mm, Xu, Xu, Xu, Cte, 5 Kte, Cte, Xu, Uh, Uu^Vu, Xu, Uu, Uh, Re^Ii, Uu, Uh, Uu, Re, Uu^Vu, Uu, Xu, Xu, Xu, Xu, Xu, Xu, Xu, Xu, Xu
Mm, Mm, Mm, Mm, Mm, Mm, Hh^Fms, Hh^Fds, Hh^Fds, Gs^Fms, Gs^Fds, Gs^Fms, Hh^Fds, Hh^Fp, Hh^Fds, Gs^Fds, Hh^Fds, Gs^Fds, Hh^Fds, Gs^Fds, Gs^Fds, Gs^Fms, Gs^Fds, Hh^Fmw, Hh, Hh^Fds, Hh, Hh, Hh^Fms, Mm, Mm, Mm, Mm, Mm, Mm, Mm, Mm, Mm, Mm, Mm, Xu, Xu, Uu, Uh, Uh, Uh, Uh, Xu, Xu, Xu, Xu, Xu, Xu, Xu, Xu, Xu, Xu, Xu, Xu, Xu, Xu, Xu, Xu, Xu, Xu, Xu, Xu
